xxxxxxxxxxxxxxxx
x xvxxx        x
x xs  x        x
x x x x        x
x x x x        x
x x x x        x
x x x x        x
x x x x        x
x x x x        x
xs  xs         x
xvxxxvx       fx
xxxxxxxxxxxxxxxx